                         RTevz	X X X X X X X X X X X X X X X X X X X X X X X X X X
                    tilbEminem	_ _ _ X X X X X X X X X X X X X X X X X X X X X X X
               Bloodcastle0301	X X X X X X X X X X X X X X X X X X X X X X X X X X
                4plottersdeals	X X X X X X X X X X X X X X X X X X X X X X X X X X
               WallaceAdverti1	X X X X X X X X X X X X X X X X X X X X X X X X X X
                 ClideRadcliff	X X X X X X X X X X X X X X X X X X X X X X X X X X
                     jripper00	X X X X X X X X X X X X X X X X X X X X X X X X X X
                   cbequillo16	_ _ _ _ _ _ _ _ _ _ _ _ _ _ _ _ _ X X X X X X X X X
               bestmobilenetwr	X X X X X X X X X X X X X X X X X X X X X X X X X X
                         Avo43	X X X X X X X X X X X X X X X X X X X X X X X X X X
                 madebyhippies	X X X X X X X X X X X X X X X X X X X X X X X X X X
                     timraftis	X X X X X X X X X X X X X X X X X X X X X X X X X X
               SocialMediaTWTR	X X X X X X X X X X X X X X X X X X X X X X X X X X
                      milaawal	X X X X X X X X X X X X X X X X X X X X X X X X X X
               PeterCullenFans	X X X X X X X X X X X X X X X X X X X X X X X X X X
                  JohnJQuinlan	X X X X X X X X X X X X X X X X X X X X X X X X X X
                     DJTSUNAMI	X X X X X X X X X X X X X X X X X X X X X X X X X X
                  uchierfandi1	X X X X X X X X X X X X X X X X X X X X X X X X X X
                  butimnota_DJ	_ _ _ _ _ _ _ _ _ X X X X X X X X X X X X X X X X X
                  scifisamurai	X X X X X X X X X X X X X X X X X X X X X X X X X X
                     Centacall	X X X X X X X X X X X X X X X X X X X X X X X X X X
                 SecretDoorEnt	X X X X X X X X X X X X X X X X X X X X X X X X X X
                Social_Fishing	X X X X X X X X X X X X X X X X X X X X X X X X X X
                      XL_Radio	X X X X X X X X X X X X X X X X X X X X X X X X X X
                 13destinyrulz	X X X X X X X X X X X X X X X X X X X X X X X X X X
                       efachka	X X X X X X X X X X X X X X X X X X X X X X X X X X
                    AtomRamsey	X X X X X X X X X X X X X X X X X X X X X X X X X X
                   BRoxanneMay	X X X X X X X X X X X X X X X X X X X X X X X X X X
                    Kennseth77	X X X X X X X X X X X X X X X X X X X X X X X X X X
               ShiddharthMitra	X X X X X X X X X X X X X X X X X X X X X X X X X X
                    Eldarlenk2	X X X _ _ _ _ _ _ _ _ _ _ _ _ _ _ _ _ _ _ _ _ _ _ _
                     manyaboyd	X X X X X X X X X X X X X X X X X X X X X X X X X X
                    ShasaSamul	X X X X X X X X X X X X X X X X X X X X X X X X X X
                 fardanyattaqi	X X X X X X X X X X X X X X X X X X X X X X X X X X
                         vumax	X X X X X X X X X X X X X X X X X X X X X X X X X X
                       AquaRug	X X X X X X X X X X X X X X X X X X X X X X X X X X
                       KAMEHEB	X X X X X X X X X X X X X X X X X X X X X X X X X X
                    aditya1958	X X X X X X X X X X X X X X X X X X X X X X X X X X
                   yoshi_blade	X X X X X X X X X X X X X X X X X X X X X X X X X X
               RickRibeiroReal	X X X X X X X X X X X X X X X X X X X X X X X X X X
                        scjudd	X X X X X X X X X X X X X X X X X X X X X X X X X X
                  Jaii_Pookiie	X X X X X X X X X X X X X X X X X X X X X X X X X X
                   BellaSoLost	X X X X X X X X X X X X X X X X X X X X X X X X X X
                 LoveOrlandoFL	X X X X X X X X X X X X X X X X X X X X X X X X X X
                     vanniinez	X X X X X X X X X X X X X X X X X X X X X X X X X X
                     edribotha	X X X X X X X X X X X X X X X X X X X X X X X X X X
                  2mobilphones	X X X X X X X X X X X X X X X X X X X X X X X X X X
                        VCBBaz	X X X X X X X X X X X X X X X X X X X X X X X X X X
                   NasyaPanova	_ _ _ X X X X X X X X X X X X X X X X X X X X X X X
                     hannyzamz	X X X X X X X X X X X X X X X X X X X X X X X X X X
                   PicStoryInc	X X X X X X X X X X X X X X X X X X X X X X X X X X
                  mattrmclaren	X X X X X X X X X X X X X X X X X X X X X X X X X X
                  TereSamantha	X X X X X X X X X X X X X X X X X X X X X X X X X X
                    NirokaLoco	X X X X X X X X X X X X X X X X X X X X X X X X X X
                      JPCARPET	X X X X X X X X X X X X X X X X X X X X X X X X X X
                    MARTYRexyz	X X X X X X X X X X X X X X X X X X X X X X X X X X
                 lestarisugeng	X X X X X X X X X X X X X X X X X X X X X X X X X X
                  ayaydinharun	_ _ _ _ _ _ _ _ _ _ _ _ _ _ X X X X X X X X X X X X
                    keremerler	X X X _ _ _ _ _ _ _ _ _ _ _ _ _ _ _ _ _ _ _ _ _ _ _
                     ActuBuzzz	_ _ _ _ _ _ _ X X X X X X X X X X X X X X X X X X X
                Gaurav_Forever	X X X X X X X X X X X X X X X X X X X X X X X X X X
               McGuireandAssoc	X X X X X X X X X X X X X X X X X X X X X X X X X X
                      NestCasa	X X X X X X X X X X X X X X X X X X X X X X X X X X
                     JAGrippin	X X X X X X X X X X X X X X X X X X X X X X X X X X
                         xVDEx	X X X X X X X X X X X X X X X X X X X X X X X X X X
                      KP_Kelly	X X X X X X X X X X X X X X X X X X X X X X X X X X
                   amiemonster	_ _ _ _ _ _ _ _ _ _ _ _ _ _ _ _ _ X X X X X X X X X
                  jaystrong347	X X X X X X X X X X X X X X X X X X X X X X X X X X
                   BrianYanMuk	X X X X X X X X X X X X X X X X X X X X X X X X X X
                     RossDigby	_ _ _ _ _ _ _ _ _ _ _ _ _ _ _ _ _ _ _ _ _ _ _ _ _ X
               DumboStartupLab	X X X X X X X X X X X X X X X X X X X X X X X X X X
                MyNameIsBuklau	X X X X X X X X X X X X X X X X X X X X X X X X X X
                   r1zkyAnanda	X X X X X X X X X X X X X X X X X X X X X X X X X X
                   Luke_Martin	X X X X X X X X X X X X X X X X X X X X X X X X X X
                      All2Need	X X X X X X X X X X X X X X X X X X X X X X X X X X
                     rio_waldy	X X X X X X X X X X X X X X X X X X X X X X X X X X
                      alabarga	X X X X X X X X X X X X X X X X X X X X X X X X X X
                 robertheadley	X X X X X X X X X X X X X X X X X X X X X X X X X X
                    OmarNaziry	X X X X X X X X X X X X X X X X X X X X X X X X X X
                         ktaht	X X X X X X X X X X X X X X X X X X X X X X X X X X
                      HarunTok	_ _ _ _ _ _ _ _ X X X X X X X X X X X X X X X X X X
                       SenayJB	X X X X X X X X X X X X X X X X X X X X X X X X X X
                    BrewerIntl	_ _ _ _ _ _ _ X X X X X X X X X X X X X X X X X X X
                       viqriFM	X X X X X X X X X X X X X X X X X X X X X X X X X X
                    kldalmalki	X X X X X X X X X X X X X X X X X X X X X X X X X X
                       FamiLAB	X X X X X X X X X X X X X X X X X X X X X X X X X X
                endofthetimeme	X X X X X X X X X X X X X X X X X X X X X X X X X X
                     SaidinWoT	X X X X X X X X X X X X X X X X X X X X X X X X X X
                PandorasFedora	X X X X X X X X X X X X X X X X X X X X X X X X X X
                michellemitchi	_ _ _ _ _ _ _ _ _ _ _ _ _ _ _ _ _ _ _ _ X _ _ _ _ _
               HelenKitchen_PR	X X X X X X X X X X X X X X X X X X X X X X X X X X
                      andrboot	X X X X X X X X X X X X X X X X X X X X X X X X X X
                 Juan_Gibran03	X X X X X X X X X X X X X X X X X X X X X X X X X X
               JoeToombsDesign	X X X X X X X X X X X X X X X X X X X X X X X X X X
                  stuartpowers	X X X X X X X X X X X X X X X X X X X X X X X X X X
                DustinBlanksma	X X X X X X X X X X X X X X X X X X X X X X X X X X
               AbrahamKhan6102	X X X X X X X X X X X X X X X X X X X X X X X X X X
                    essanmarie	X X X X X X X X X X X X X X X X X X X X X X X X X X
                      ronrikei	X X X X X X X X X X X X X X X X X X X X X X X X X X
                 EvolvingTechs	X X X X X X X X X X X X X X X X X X X X X X X X X X
                    WolfyCrabb	X X X X X X X X X X X X X X X X X X X X X X X X X X
                        dpbkmb	X X X X X X X X X X X X X X X X X X X X X X X X X X
                       dpkalie	X X X X X X X X X X X X X X X X X X X X X X X X X X
                     iAlwaysTK	X X X X X X X X X X X X X X X X X X X X X X X X X X
               iRomeHypnotized	_ _ _ X X X X X X X X X X X X X X X X X X X X X X X
                Genesis_Factor	X X X X X X X X X X X X X X X X X X X X X X X X X X
               container_osaka	X X X X X X X X X X X X X X X X X X X X X X X X X X
               torontocitylife	X X X X X X X X X X X X X X X X X X X X X X X X X X
                 IndieFilmNOLA	X X X X X X X X X X X X X X X X X X X X X X X X X X
                EkaHeriyansyah	X X X X X X X X X X X X X X X X X X X X X X X X X X
                digitalman2112	X X X X X X X X X X X X X X X X X X X X X X X X X X
                   AmBioVision	X X _ X _ X X X X X X X X X X X _ X X X X X _ X X _
                      gKeyLOVE	X X X X X X X X X X X X X X X X X X X X X X X X X X
                    who_says95	_ _ _ _ _ _ _ _ _ _ _ _ _ _ _ _ _ _ _ _ _ _ _ X X X
                    dwymonster	X X X X X X X X X X X X X X X X X X X X X X X X X X
                  toyzdarkside	X X X X X X X X X X X X X X X X X X X X X X X X X X
                    Arif_Iqbar	X X X X X X X X X X X X X X X X X X X X X X X X X X
                 MertKomitgan8	_ _ _ _ _ _ _ _ _ _ _ _ _ _ _ X X X X X X X X X X X
                        ernymz	X X X X X X X X X X X X X X X X X X X X X X X X X X
                   TEDxOrlando	X X X X X X X X X X X X X X X X X X X X X X X X X X
                atbreakupalarm	X X X X X X X X X X X X X X X X X X X X X X X X X X
                      s1f2s3r4	_ _ _ _ _ _ _ _ _ _ _ _ _ _ _ _ _ _ _ _ _ X X X X X
                      unhosted	X X X X X X X X X X X X X X X X X X X X X X X X X X
                  BrandiPayton	X X X X X X X X X X X X X X X X X X X X X X X X X X
               InFeRNoOFFlCiAL	X X X X X X X X X X X X X X X X X X X X X X X X X X
                    not_Ronald	X X X X X X X X X X X X X X X X X X X X X X X X X X
                 hotelbooking8	X X X X X X X X X X X X X X X X X X X X X X X X X X
                     asouviron	X X X X X X X X X X X X X X X X X X X X X X X X X X
                Dmitriy_Osipov	X X X X X X X X X X X X X X X X X X X X X X X X X X
                    thxmaspert	_ _ _ X X X X X X X X X X X X X X X X X X X X X X X
                      Rhessay_	X X X X X X X X X X X X X X X X X X X X X X X X X X
                         rwuah	X X X X X X X X X X X X X X X X X X X X X X X X X X
                 ReaganKeith16	X X X X X X X X X X X X X X X X X X X X X X X X X X
               USASSETRECOVERY	X X X X X X X X X X X X X X X X X X X X X X X X X X
                 personalcare3	X X X X X X X X X X X X X X X X X X X X X X X X X X
                     iShortBus	X X X X X X X X X X X X X X X X X X X X X X X X X X
                     Yohane_LR	X X X X X X X X X X X X X X X X X X X X X X X X X X
                   vereduscorp	X X X X X X X X X X X X X X X X X X X X X X X X X X
                   Kalembo_Ade	X X X X X X X X X X X X X X X X X X X X X X X X X X
                      athaliaw	X X X X X X X X X X X X X X X X X X X X X X X X X X
                      PediSpin	X X X X X X X X X X X X X X X X X X X X X X X X X X
                 shamilnunhuck	X X X X X X X X X X X X X X X X X X X X X X X X X X
                   5TRILLNEIL4	X X X X X X X X X X X X X X X X X X X X X X X X X X
                   ClarkMarc09	X X X X X X X X X X X X X X X X X X X X X X X X X X
               OrlandoTechMeet	X X X X X X X X X X X X X X X X X X X X X X X X X X
                      bayooonk	X X X X X X X X X X X X X X X X X X X X X X X X X X
                        dpflug	X X X X X X X X X X X X X X X X X X X X X X X X X X
                   matt_lavine	_ _ _ X X X X X X X X X X X X X X X X X X X X X X X
                  sunshineq117	X X X X X X X X X X X X X X X X X X X X X X X X X X
                 colbinhendrix	X X X X X X X X X X X X X X X X X X X X X X X X X X
                 JongkySantosa	X X X X X X X X X X X X X X X X X X X X X X X X _ _
                          bigs	X X X X X X X X X X X X X X X X X X X X X X X X X X
                    onlyJustyn	X X X X X X X X X X X X X X X X X X X X X X X X X X
               HealthierLifeCo	X X X X X X X X X X X X X X X X X X X X X X X X X X
                elshowderulito	X X X X X X X X X X X X X X X X X X X X X X X X X X
               Adlirizkyhilmy2	X X X X X X X X X X X X X X X X X X X X X X X X X X
               iamdavidsimpson	X X X X X X X X X X X X X X X X X X X X X X X X X X
                    LunchboxZU	X X X X X X X X X X X X X X X X X X X X X X X X X X
                  motive4U2see	X X X X X X X X X X X X X X X X X X X X X X X X X X
                badhon04994796	X X X X X X X X X X X X X X X X X X X X X X X X X X
                    ZakkdLarte	X X X X X X X X X X X X X X X X X X X X X X X X X X
                 BrokersChoice	X X X X X X X X X X X X X X X X X X X X X X X X X X
                  EmpiricalCEO	X X X X X X X X X X X X X X X X X X X X X X X X X X
                       yuexion	X X X X X X X X X X X X X X X X X X X X X X X X X X
                    MezMerrett	X X X X X X X X X X X X X X X X X X X X X X X X X X
                   Andr3wPerez	X X X X X X X X X X X X X X X X X X X X X X X X X X
                       jovica6	X X X X X X X X X X X X X X X X X X X X X X X X X X
                   adsenseTech	X X X X X X X X X X X X X X X X X X X X X X X X X X
                       V_xklsv	X X X X X X X X X X X X X X X X X X X X X X X X X X
                    CodyyBeatz	X X X X X X X X X X X X X X X X X X X X X X X X X X
                      davehoff	X X X X X X X X X X X X X X X X X X X X X X X X X X
                     wrc_of_ny	X X X X X X X X X X X X X X X X X X X X X X X X X X
               Budget_Thailand	_ _ _ _ _ _ _ _ _ _ _ _ _ _ _ _ _ _ _ _ _ _ _ X X X
                      iamyayel	X X X X X X X X X X X X X X X X X X X X X X X X X X
                     Donwan198	_ _ _ _ _ _ _ _ _ X X X X X X X X X X X X X X X X X
               UNeverKnowGirls	X X X X X X X X X X X X X X X X X X X X X X X X X X
                    TheWorlddd	X X X X X X X X X X X X X X X X X X X X X X X X X X
                     dmilligan	X X X X X X X X X X X X X X X X X X X X X X X X X X
                NewGateCapital	X X X X X X X X X X X X X X X X X X X X X X X X X X
                     D_Kissoon	X X X X X X X X X X X X X X X X X X X X X X X X X X
                 monikagupta4u	X X X X X X X X X X X X X X X X X X X X X X X X X X
                 DonKromodirjo	X X X X X X X X X X X X X X X X X X X X X X X X X X
                  hajimeya_bar	X X X X X X X X X X X X X X X X X X X X X X X X X X
                     wwtonline	X X X X X X X X X X X X X X X X X X X X X X X X X X
                 MaxAhMillion_	X X X X X X X X X X X X X X X X X X X X X X X X X X
                          _Cod	X X X X X X X X X X X X X X X X X X X X X X X X X X
                    Apchel1980	X X X X X X X X X X X X X X X X X X X X X X X X X X
                     libwat_ch	X X X X X X X X X X X X X X X X X X X X X X X X X X
                      sms_zone	X X X X X X X X X X X X X X X X X X X X X X X X X X
               _RealKiddFresh_	X X X X X X X X X X X X X X X X X X X X X X X X X X
                   fuatyilmaz1	X X X X X X X X X X X X X X X X X X X X X X X X X X
                 ElMasSeguidor	X X X X X X X X X X X X X X X X X X X X X X X X X X
                 cilegonpassfm	_ _ _ X X X X X X X X X X X X X X X X X X X X X X X
                   SmokedByCBZ	X X X X X X X X X X X X X X X X X X X X X X X X X X
                sikandar_bilal	X X X X X X X X X X X X X X X X X X X X X X X X X X
                      link2how	X X X X X X X X X X X X X X X X X X X X X X X X X X
                     na_noha24	X X X X X X X X X X X X X X X X X X X X X X X X X X
                  deivi_vargas	X X X X X X X X X X X X X X X X X X X X X X X X X X
                  doragon88040	X X X X X X X X X X X X X X X X X X X X X X X X X X
                     fred_zara	X X X X X X X X X X X X X X X X X X X X X X X X X X
                    arunraja_s	X X X X X X X X X X X X X X X X X X X X X X X X X X
                      y_laresv	X X X X X X X X X X X X X X X X X X X X X X X X X X
               TitleVIIWarrior	X X X X X X X X X X X X X X X X X X X X X X X X X X
                      maddentw	X X X X X X X X X X X X X X X X X X X X X X X X X X
                WatchSports_TV	X X X X X X X X X X X X X X X X X X X X X X X X X X
                        dahl1a	X X X X X X X X X X X X X X X X X X X X X X X X X X
                     pvasilion	X X X X X X X X X X X X X X X X X X X X X X X X X X
                     dealsbell	X X X X X X X X X X X X X X X X X X X X X X X X X X
                   _ThePirates	X X X X X X X X X X X X X X X X X X X X X X X X X X
                mike_hotspaces	X X X X X X X X X X X X X X X X X X X X X X X X X X
                    trainin_ru	X X X X X X X X X X X X X X X X X X X X X X X X X X
                 TurnaTurnBaby	X X X X X X X X X X X X X X X X X X X X X X X X X X
                    amairisefi	X X X X X X X X X X X X X X X X X X X X X X X X X X
                    dodero2008	X X X X X X X X X X X X X X X X X X X X X X X X X X
                 EasyMediaAsia	_ _ _ _ _ _ _ _ _ _ _ _ _ _ _ _ _ _ _ _ _ X X X X X
               wahyucahyoyoung	X X X X X X X X X X X X X X X X X X X X X X X X X X
                     yogisonia	X X X X X X X X X X X X X X X X X X X X X X X X X X
                 lengluichicks	X X X X X X X X X X X X X X X X X X X X X X X X X X
               Khenoo_LIVEWIRE	X X X X X X X X X X X X X X X X X X X X X X X X X X
                    wordymusic	X X X X X X X X X X X X X X X X X X X X X X X X X X
                ZENDAYAC0IEMAN	X X X X X X X X X X X X X X X X X X X X X X X X X X
                  CurtisXMeyer	X X X X X X X X X X X X X X X X X X X X X X X X X X
                   sapporodeli	X X X X X X X X X X X X X X X X X X X X X X X X X X
                      iyitwit_	X X X X X X X X X X X X X X X X X X X X X X X X X X
                    BigFishMin	X X X X X X X X X X X X X X X X X X X X X X X X X X
                  Imadoki_Girl	X X X X X X X X X X X X X X X X X X X X X X X X X X
                 EdwardsHamlin	X X X X X X X X X X X X X X X X X X X X X X X X X X
                    ClimaWorld	X X X X X X X X X X X X X X X X X X X X X X X X X X
                       ilanham	X X X X X X X X X X X X X X X X X X X X X X X X X X
                 ANTicipaytion	X X X X X X X X X X X X X X X X X X X X X X X X X X
                 BeeDeeSwaggna	X X X X X X X X X X X X X X X X X X X X X X X X X X
                MacKidIowaCity	X X X X X X X X X X X X X X X X X X X X X X X X X X
                  JesseSkinner	X X X X X X X X X X X X X X X X X X X X X X X X X X
                   OtanSkaters	X X X X X X X X X X X X X X X X X X X X X X X X X X
                    fuzzyglobe	X X X X X X X X X X X X X X X X X X X X X X X X X X
                    dheesiruet	X X X X X X X X X X X X X X X X X X X X X X X X X X
                         tawlk	X X X X X X X X X X X X X X X X X X X X X X X X X X
                  Tommy_Cannon	X X X X X X X X X X X X X X X X X X X X X X X X X X
                    ThisIsReem	X X X X X X X X X X X X X X X X X X X X X X X X X X
                freepeople2020	X X X X X X X X X X X X X X X X X X X X X X X X X X
               Beauty101Secret	X X X X X X X X X X X X X X X X X X X X X X X X X X
                         1Rail	X X X X X X X X X X X X X X X X X X X X X X X X X X
                       Almarvm	X X X X X X X X X X X X X X X X X X X X X X X X X X
                     DAAbrams1	X X X X X X X X X X X X X X X X X X X X X X X X X X
                     moniksa13	X X X X X X X X X X X X X X X X X X X X X X X X X X
                  AaronOliver9	X X X X X X X X X X X X X X X X X X X X X X X X X X
                    JohnPaton7	X X X X X X X X X X X X X X X X X X X X X X X X X X
                 AZZ_CHE_PIZZA	X X X X X X X X X X X X X X X X X X X X X X X X X X
                   joemcmackin	X X X X X X X X X X X X X X X X X X X X X X X X X X
                     Atila__85	X X X X X X X X X X X X X X X X X X X X X X X X X X
                     4Plotters	X X X X X X X X X X X X X X X X X X X X X X X X X X
               JenniferReviews	X X X X X X X X X X X X X X X X X X X X X X X X X X
                GetAcaiBerries	X X X X X X X X X X X X X X X X X X X X X X X X X X
               JonathonMeinema	X X X X X X X X X X X X X X X X X X X X X X X X X X
                   CarbonGames	X X X X X X X X X X X X X X X X X X X X X X X X X X
                  oziefahrezie	X X X X X X X X X X X X X X X X X X X X X X X X X X
                 K_2_Marketing	X X X X X X X X X X X X X X X X X X X X X X X X X X
                 ArtsBasketcom	X X X X X X X X X X X X X X X X X X X X X X X X X X
                    mooregreen	X X X X X X X X X X X X X X X X X X X X X X X X X X
               marklawgoldstar	X X X X X X X X X X X X X X X X X X X X X X X X X X
                     dessertly	X X X X X X X X X X X X X X X X X X X X X X X X X X
                 markwschaefer	X X X X X X X X X X X X X X X X X X X X X X X X X X
               trisarahtops000	X X X X X X X X X X X X X X X X X X X X X X X X X X
                       Seddy90	X X X X X X X X X X X X X X X X X X X X X X X X X X
                      basttiao	X X X X X X X X X X X X X X X X X X X X X X X X X X
                    guyrbailey	X X X X X X X X X X X X X X X X X X X X X X X X X X
                   CeceXXTwitt	X X X X X X X X X X X X X X X X X X X X X X X X X X
                  Vangloryband	X X X X X X X X X X X X X X X X X X X X X X X X X X
                       KaeJudd	X X X X X X X X X X X X X X X X X X X X X X X X X X
                SayingsForBoyz	X X X X X X X X X X X X X X X X X X X X X X X X X X
                       biv1904	X X X X X X X X X X X X X X X X X X X X X X X X X X
                timstjernkvist	X X X X X X X X X X X X X X X X X X X X X X X X X X
               RichGirlsCloset	X X X X X X X X X X X X X X X X X X X X X X X X X X
               roby_setiawan17	_ _ _ X X X X X X _ _ _ _ _ _ _ _ _ _ _ _ _ _ _ _ _
                alhurriyyahipb	X X X X X X X X X X X X X X X X X X X X X X X X X X
                         Oofli	_ _ _ _ _ _ _ _ _ _ _ _ _ _ _ X X X X X X X X X X X
               JunkPirateMusic	X X X X X X X X X X X X X X X X X X X X X X X X X X
                        PayCmd	X X X X X X X X X X X X X X X X X X X X X X X X X X
                   qwertyUandI	X X X X X X X X X X X X X X X X X X X X X X X X X X
                         rclow	X X X X X X X X X X X X X X X X X X X X X X X X X X
                        refynr	X X X X X X X X X X X X X X X X X X X X X X X X X X
                 makalajohnson	X X X X X X X X X X X X X X X X X X X X X X X X X X
                  MaleFollower	X X X X X X X X X X X X X X X X X X X X X X X X X X
                 sanacroozblog	X X X X X X X X X X X X X X X X X X X X X X X X X X
                 GianvitoForte	X X X X X X X X X X X X X X X X X X X X X X X X X X
                 Music_Bullet_	X X X X X X X X X X X X X X X X X X X X X X X X X X
                        Elizle	X X X X X X X X X X X X X X X X X X X X X X X X X X
                Andy_Spongebob	_ _ _ _ _ _ X X X X X X X X X X X X X X X X X X X X
                      iwa00000	X X X X X X X X X X X X X X X X X X X X X X X X X X
                Jbella_Rielian	X X X X X X X X X X X X X X X X X X X X X X X X X X
                    BayuRAWRRR	X X X X X X X X X X X X X X X X X X X X X X X X X X
                    Si_Alphard	X X X X X X X X X X X X X X X X X X X X X X X X X X
                         bil2k	X X X X X X X X X X X X X X X X X X X X X X X X X X
                  Navy_Khalifa	X X X X X X X X X X X X X X X X X X X X X X X X X X
                     JoyAtDell	X X X X X X X X X X X X X X X X X X X X X X X X X X
               x__SkinnyMinnie	X X X X X X X X X X X X X X X X X X X X X X X X X X
                      Ansadi10	X X X X X X X X X X X X X X X X X X X X X X X X X X
                 thenakedpulse	X X X X X X X X X X X X X X X X X X X X X X X X X X
                       arifJa_	_ _ _ _ _ _ _ _ _ _ _ _ _ _ _ _ _ _ X X X X X X X X
                    Ramanda_Gz	X X X X X X X X X X X X X X X X X X X X X X X X X X
               sheridans_guide	X X X X X X X X X X X X X X X X X X X X X X X X X X
               CloverFieldJohn	X X X X X X X X X X X X X X X X X X X X X X X X X X
                         voxeo	X X X X X X X X X X X X X X X X X X X X X X X X X X
                  imsomniaa212	X X X X X X X X X X X X X X X X X X X X X X X X X X
                 AffiliationFr	X X X X X X X X X X X X X X X X X X X X X X X X X X
                  LanceMcMInn1	X X X X X X X X X X X X X X X X X X X X X X X X X X
                     Newton_LR	X X X X X X X X X X X X X X X X X X X X X X X X X X
                      trovian7	X X X X X X X X X X X X X X X X X X X X X X X X X X
                      Wantbies	X X X X X X X X X X X X X X X X X X X X X X X X X X
                      FluSick1	X X X X X X X X X X X X X X X X X X X X X X X X X X
                   ViralUpload	X X X X X X X X X X X X X X X X X X X X X X X X X X
                    Marcqueezy	X X X X X X X X X X X X X X X X X X X X X X X X X X
               ririncutepupita	X X X X X X X X X X X X X X X X X X X X X X X X X X
                Tell_me_Shop_2	X X X X X X X X X X X X X X X X X X X X X X X X X X
                DirtyRockerzzz	X X X X X X X X X X X X X X X X X X X X X X X X X X
                     _FreAkZ_1	_ _ _ _ _ _ _ _ _ _ _ _ X X _ _ _ _ _ _ _ _ _ _ _ _
                     PutryNhya	X X X X X X X X X X X X X X X X X X X X X X X X X X
                     surby1000	X X X X X X X X X X X X X X X X X X X X X X X X X X
                  CoopZ_HackeR	X X X X X X X X X X X X X X X X X X X X X X X X X X
               villasandhomeso	X X X X X X X X X X X X X X X X X X X X X X X X X X
                   RUSHERS1601	X X X X X X X X X X X X X _ _ _ _ _ _ _ _ _ _ _ _ _
                         l3_cR	X X X X X X X X X X X X X X X X X X X X X X X X X X
                    BestSarita	X X X X X X X X X X X X X X X X X X X X X X X X X X
                      _wahyuAN	_ _ X X X X X X X X X X X X X X X X X X X X X X X X
                     FizzNakLe	X X X X X X X X X X X X X X X X X X X X X X X X X X
                       Ay_Talk	X X X X X X X X X X X X X X X X X X X X X X X X X X
                   SammyBoyDPK	X X X X X X X X X X X X X X X X X X X X X X X X X X
                 johnspalding4	X X X X X X X X X X X X X X X X X X X X X X X X X X
                      Venice30	X X X X X X X X X X X X X X X X X X X X X X X X X X
                     SchwartaQ	_ _ _ _ _ _ _ _ _ X X X X X X X X X X X X X X X X X
                        bersou	X X X X X X X X X X X X X X X X X X X X X X X X X X
                 IdolsofHipHop	X X X X X X X X X X X X X X X X X X X X X X X X X X
               jackhernandezvc	X X X X X X X X X X X X X X X X X X X X X X X X X X
                      doeswhat	X X X X X X X X X X X X X X X X X X X X X X X X X X
                    bookgirl88	X X X X X X X X X X X X X X X X X X X X X X X X X X
                   twingzgeeks	_ _ _ _ _ _ _ _ _ _ _ _ X X X X X X X X X X X X X X
                   HamadFeehan	_ _ _ _ _ _ _ _ _ _ _ _ _ X X X X X X X X X X X X X
                      FatalBSM	X X X X X X X X X X X X X X X X X X X X X X X X X X
                BelajarAlkitab	X X X X X X X X X X X X X X X X X X X X X X X X X X
                      Tye_Kemp	X X X X X X X X X X X X X X X X X X X X X X X X X X
               georgia_mooneyx	X X X X X X X X X X X X X X X X X X X X X X X X X X
                     S_Abhinay	X X X X X X X X X X X X X X X X X X X X X X X X X X
                 Disclosure101	X X X X X X X X X X X X X X X X X X X X X X X X X X
                 HykMawT_ImHKM	X X X X X X X X X X X X X X X X X X X X X X X X X X
                       TMobile	X X X X X X X X X X X X X X X X X X X X X X X X X X
                      akuaiBOB	X X X X X X X X X X X X X X X X X X X X X X X X X X
                  DailyUSANews	_ _ _ _ _ _ _ _ _ _ _ _ _ _ _ _ _ _ _ _ _ _ X X X X
                         a_lyx	X X X X X X X X X X X X X X X X X X X X X X X X X X
                 Moraleshannah	X X X X X X X X X X X X X X X X X X X X X X X X X X
                   CalvinLeo09	X X X X X X X X X X X X X X X X X X X X X X X X X X
                    HTHoldings	X X X X X X X X X X X X X X X X X X X X X X X X X X
                        desmaj	X X X X X X X X X X X X X X X X X X X X X X X X X X
                      STEVEPMP	X X X X X X X X X X X X X X X X X X X X X X X X X X
                 IbrahimImran1	_ _ _ _ _ _ _ _ _ _ _ X X X X X X X X X X X X _ _ _
                  AesthetiCare	X X X X X X X X X X X X X X X X X X X X X X X X X X
                 PennyandPaper	X X X X X X X X X X X X X X X X X X X X X X X X X X
                  anahi__lopez	X X X X X X X X X X X X X X X X X X X X X X X X X X
                      DjStrapz	X X X X X X X X X X X X X X X X X X X X X X X X X X
                 GeorgiaRomain	X X X X X X X X X X X X X X X X X X X X X X X X X X
                   tete_de_con	_ _ _ _ _ _ _ _ X X X X X X X X X X X X X X X X X X
                    SirHacksaw	X X X X X X X X X X X X X X X X X X X X X X X X X X
                    ItsSelena1	X X X X X X X X X X X X X X X X X X X X X X X X X X
                        Hezzah	X X X X X X X X X X X X X X X X X X X X X X X X X X
               Harisirvandani1	X X X X X X X X X X X X X X X X X X X X X X X X X X
                JasonPromotesU	X X X X X X X X X X X X X X X X X X X X X X X X X X
                  Capt_RonRico	X X X X X X X X X X X X X X X X X X X X X X X X X X
                      JHenning	X X X X X X X X X X X X X X X X X X X X X X X X X X
                  GenZero_CEDU	X X X X X X X X X X X X X X X X X X X X X X X X X X
                   ian_mullins	X X X X X X X X X X X X X X X X X X X X X X X X X X
                       lgneasy	X X X X X X X X X X X X X X X X X X X X X X X X X X
                       MykirLP	X X X X X X X X X X X X X X X X X X X X X X X X X X
                buddhawithlove	X X X X X X X X X X X X X X X X X X X X X X X X X X
                     Manu01_LR	X X X X X X X X X X X X X X X X X X X X X X X X X X
                     TuiVaaulu	X X X X X X X X X X X X X X X X X X X X X X X X X X
               BangkokOHOMassa	X X X X X X X X X X X X X X X X X X X X X X X X X X
                        Jinx0_	X X X X X X X X X X X X X X X X X X X X X X X X X X
               AFreakOfSociety	X X X X X X X X X X X X X X X X X X X X X X X X X X
                   surendraimr	X X X X X X X X X X X X X X X X X X X X X X X X X X
                   aji_anugrah	X X X X X X X X X X X X X X X X X X X X X X X X X X
                 LalitBhojwani	X X X X X X X X X X X X X X X X X X X X X X X X X X
                        okebbs	X X X X X X X X X X X X X X X X X X X X X X X X X X
                    LakateBH01	X X X X X X X X X X X X X X X X X X X X X X X X X X
                 FollowerCrazy	X X X X X X X X X X X X X X X X X X X X X X X X X X
                 MissDestructo	X X X X X X X X X X X X X X X X X X X X X X X X X X
                     Allie7ov3	X X X X X X X X X X X X X X X X X X X X X X X X X X
                       Emre07i	X X X X X X X X X X X X X X X X X X X X X _ _ _ _ _
                Recce233Savoie	X X X X X X X X X X X X X X X X X X X X X X X X X X
                 ITRecruitJake	X X X X X X X X X X X X X X X X X X X X X X X X X X
                       firefox	X X X X X X X X X X X X X X X X X X X X X X X X X X
                  theepicsnail	X X X X X X X X X X X X X X X X X X X X X X X X X X
                 CentreFriends	X X X X X X X X X X X X X X X X X X X X X X X X X X
                  BrentScott09	X X X X X X X X X X X X X X X X X X X X X X X X X X
                  marcuslorenz	X X X X X X X X X X X X X X X X X X X X X X X X X X
                   CHAIKARHENG	X X X X X X X X X X X X X X X X X X X X X X X X X X
                         mrHTN	X X X X X X X X X X X X X X X X X X X X X X X X X X
                        100_TB	X X X X X X X X X X X X X X X X X X X X X X X X X X
                     SyBuVyInc	X X X X X X X X X X X X X X X X X X X X X X X X X X
               __ShawtySaid___	X X X X X X X X X X X X X X X X X X X X X X X X X X
                Venkatvijayfan	X X X X X X X X X X X X X X X X X X X X X X X X X X
                     freereadr	X X X X X X X X X X X X X X X X X X X X X X X X X X
                      Ankit_26	X X X X X X X X X X X X X X X X X X X X X X X X X X
                      moyo_moy	X X X X X X X X X X X X X X X X X X X X X X X X X X
                      Adea_Tyr	X X X X X X X X X X X X X X X X X X X X X X X X X X
                    DefiantSun	X X X X X X X X X X X X X X X X X X X X X X X X X X
                 konya_mevlana	X X X X X X X X X X X X X X X X X X X X X X X X X X
                      al_the_x	X X X X X X X X X X X X X X X X X X X X X X X X X X
                       tbachme	X X X X X X X X X X X X X X X X X X X X X X X X X X
                MidAmericaIowa	X X X X X X X X X X X X X X X X X X X X X X X X X X
                      jsharkey	X X X X X X X X X X X X X X X X X X X X X X X X X X
                       neoasix	X X X X X X X X X X X X X X X X X X X X X X X X X X
               ghinaayulestar3	X X X X X X X X X X X X X X X X X X X X X X X X X X
                 Fr3nCH_InH4Le	X X X X X X X X X X X X X X X X X X X X X X X X X X
                    aleebrahim	X X X X X X X X X X X X X X X X X X X X X X X X X X
                     mslsasdkv	X X X X X X X X X X X X X X X X X X X X X X X X X X
                       yhanddp	X X X X X X X _ _ _ _ _ _ _ _ _ _ _ _ _ _ _ _ _ _ _
                        promtr	X X X X X X X X X X X X X X X X X X X X X X X X X X
                        hpagey	X X X X X X X X X X X X X X X X X X X X X X X X X X
               TheOneToMention	X X X X X X X X X X X X X X X X X X X X X X X X X X
                ServiceDuckcom	X X X X X X X X X X X X X X X X X X X X X X X X X X
                 InvestSmartUK	X X X X X X X X X X X X X X X X X X X X X X X X X X
                n8_RReynaztal_	X X X X X X X X X X X X X X X X X X X X X X X X X X
                   Swaggerene1	_ _ _ _ _ _ _ _ _ _ _ _ _ _ _ _ _ X X X X X X X X X
                      Micizlee	_ _ _ _ _ _ _ _ _ _ _ X X X X X X X X X X X X X X X
                      nginxorg	X X X X X X X X X X X X X X X X X X X X X X X X X X
                      SilKetty	X X X X X X X X X X X X X X X X X X X X X X X X X X
                   NTheAirNewz	X X X X X X X X X X X X X X X X X X X X X X X X X X
                 TheOnlyCentri	X X X X X X X X X X X X X X X X X X X X X X X X X X
                    dgreichert	X X X X X X X X X X X X X X X X X X X X X X X X X X
                      123top10	X X X X X X X X X X X X X X X X X X X X X X X X X X
                   dashinggame	X X X X X X X X X X X X X X X X X X X X X X X X X X
                     dmnckogdn	X X X X X X X X X X X X X X X X X X X X X X X X X X
                        rikiji	X X X X X X X X X X X X X X X X X X X X X X X X X X
                  seedingideas	X X X X X X X X X X X X X X X X X X X X X X X X X X
               LIVINGUPSUCCESS	X X X X X X X X X X X X X X X X X X X X X X X X X X
               KerenRubenstein	X X X X X X X X X X X X X X X X X X X X X X X X X X
                 imkathrynluna	X X X X X X X X X X X X X X X X X X X X X X X X X X
                     Omni_Perk	X X X X X X X X X X X X X X X X X X X X X X X X X X
                Itz_DaNNi_dUhh	X X X X X X X X X X X X X X X X X X X X X X X X X X
                     planomike	X X X X X X X X X X X X X X X X X X X X X X X X X X
                     SarahABDS	X X X X X X X X X X X X X X X X X X X X X X X X X X
               RayRayWilkinson	X X X X X X X X X X X X X X X X X X X X X X X X X X
                   Alena_Apina	X X X X X X X X X X X X X X X X X X X X X X X X X X
                      R4isdhcc	X X X X X X X X X X X X X X X X X X X X X X X X X X
               PerriKardashian	X X X X X X X X X X X X X X X X X X X X X X X X X X
               KamranChughtai7	X X X X X X X X X X X X X X X X X X X X X X X X X X
                      alldenka	X X X X X X X X X X X X X X X X X X X X X X X X X X
                 ImagineNormal	X X X X X X X X X X X X X X X X X X X X X X X X X X
                allvinDesigner	_ _ _ _ _ _ _ _ _ _ _ _ _ _ _ _ _ _ _ _ _ _ X X X X
                    nocta_clup	X X X X X X X X X X X X X X X X X X X X X X X X X X
                     veenobala	X X X X X X X X X X X X X X X X X X X X X X X X X X
                      InfoKulo	X X X X X X X X X X X X X X X X X X X X X X X X X X
                  villanhisham	X X X X X X X X X X X X X X X X X X X X X X X X X X
                 ChrackRoyalty	X X X X X X X X X X X X X X X X X X X X X X X X X X
                     jaltucher	X X X X X X X X X X X X X X X X X X X X X X X X X X
                 EarthDisciple	X X X X X X X X X X X X X X X X X X X X X X X X X X
                   iamsofraven	X X X X X X X X X X _ _ _ _ _ _ _ _ _ _ _ _ _ _ _ _
                        yulper	_ _ _ _ _ _ _ _ _ _ _ _ _ _ _ _ _ _ _ _ _ _ _ _ _ X
               AshleyFenixSmit	X X X X X X X X X X X X X X X X X X X X X X X X X X
                uthebombdotcom	X X X X X X X X X X X X X X X X X X X X X X X X X X
                       aregmag	X X X X X X X X X X X X X X X X X X X X X X X X X X
                    SylviaKoss	X X X X X X X X X X X X X X X X X X X X X X X X X X
                     Shivayoga	X X X X X X X X X X X X X X X X X X X X X X X X X X
                       Miro_15	X X X X X X X X X X X X X X X X X X X X X X X X X X
                 RedSQRdotMobi	X X X X X X X X X X X X X X X X X X X X X X X X X X
                 healthpromote	X X X X X X X X X X X X X X X X X X X X X X X X X X
                   CrzyGatorFL	X X X X X X X X X X X X X X X X X X X X X X X X X X
                     skidmore1	X X X X X X X X X X X X X X X X X X X X X X X X X X
                  socrates1024	X X X X X X X X X X X X X X X X X X X X X X X X X X
                       RareCat	X X X X X X X X X X X X X X X X X X X X X X X X X X
                SelinSabrioglu	X X X X X X X X X X X X X X X X X X X X X X X X X X
               bearunderground	X X X X X X X X X X X X X X X X X X X X X X X X X X
               SpaceCowboyJeff	_ _ _ _ _ _ _ _ _ _ _ _ _ _ _ _ _ _ _ _ _ _ _ X _ _
                 praveengodara	X X X X X X X X X X X X X X X X X X X X X X X X X X
                  DJDangerous_	X X X X X X X X X X X X X X X X X X X X X X X X X X
                 BankMoreMoney	X X X X X X X X X X X X X X X X X X X X X X X X X X
                    RickStarr_	_ _ _ _ _ _ _ X X X X X X X X X X X X X X X X X X X
               DealExtremeFans	X X X X X X X X X X X X X X X X X X X X X X X X X X
                    yuu_san555	X X X X X X X X X X X X X X X X X X X X X X X X X X
                  nadaibtihaly	X X X X X X X X X X X X X X X X X X X X X X X X X X
                     BeSublime	X X X X X X X X X X X X X X X X X X X X X X X X X X
                    HARNORIZER	X X X X X X X X X X X X X X X X X X X X X X X X X X
                enchancer_swag	_ _ _ _ _ _ _ X _ _ _ _ _ _ _ _ _ _ _ _ _ _ _ _ _ _
                  GodAvrilZayn	X X X X X X X X X X X X X X X X X X X X X X X X X X
                      Royyboii	X X X X X X X X X X X X X X X X X X X X X X X X X X
                  Annisa_Arisa	X _ _ _ _ _ _ _ _ _ _ _ _ _ _ _ _ _ _ _ _ _ _ _ _ _
                  KerryGorgone	X X X X X X X X X X X X X X X X X X X X X X X X X X
                    veredusorl	X X X X X X X X X X X X X X X X X X X X X X X X X X
                       Hamoote	X X X X X X X X X X X X X X X X X X X X X X X X X X
                    DenyNovryy	X X X X X X X X X X X X X X X X X X X X X X X X X X
                      gphxgphx	X X X X X X X X X X X X X X X X X X X X X X X X X X
                      notybari	X X X X X X X X X X X X X X X X X X X X X X X X X X
                   lumaticnoel	X X X X X X X X X X X X X X X X X X X X X X X X X X
                  Titis_street	X X X X X X X X X X X X X X X X X X X X X X X X X X
                      Edho_W3r	X X X X X X X X X X X X X X X X X X X X X X X X X X
                     Gwynstone	X X X X X X X X X X X X X X X X X X X X X X X X X X
                     Amelloo13	X X X X X X X X X X X X X X X X X X X X X X X X X X
                   jelita_nara	X X X _ _ _ _ _ _ _ _ _ _ _ _ _ _ _ _ _ _ _ _ _ _ _
                 AListEvents4U	X X X X X X X X X X X X X X X X X X X X X X X X X X
                   zachguthrie	X X X X X X X X X X X X X X X X X X X X X X X X X X
               BitcoinForumCom	X X X X X X X X X X X X X X X X X X X X X X X X X X
                  Nissa2Tatted	X X X X X X X X X X X X X X X X X X X X X X X X X X
                       myikeda	X X X X X X X X X X X X X X X X X X X X X X X X X X
                    iwamizawan	X X X X X X X X X X X X X X X X X X X X X X X X X X
                    tankoriant	X X X X X X X X X X X X X X X X X X X X X X X X X X
                       wbevins	X X X X X X X X X X X X X X X X X X X X X X X X X X
                 TryJuliopusam	X X X X X X X X X X X X X X X X X X X X X X X X X X
                        DiaaXS	X X X X X X X X X X X X X X X X X X X X X X X X X X
                 FrvrTwntynine	X X X X X X X X X X X X X X X X X X X X X X X X X X
                        iedath	X X X X X X X X X X X X X X X X X X X X X X X X X X
                     Skylargpn	X X X X X X X X X X X X X X X X X X X X X X X X X X
               DigitalDelight_	X X X X X X X X X X X X X X X X X X X X X X X X X X
                SalimAlfahrisy	_ _ _ _ _ _ _ _ _ X X X X X X X X X X X X X X X X X
                   GianmarcoGP	X X X X X X X X X X X X X X X X X X X X X X X X X X
                     EmoMrDark	X X X X X X X X X X X X X X X X X X X X X X X X X X
               InterCapital_RE	X X X X X X X X X X X X X X X X X X X X X X X X X X
                  STAYFOOLiiSH	X X X X X X X X X X X X X X X X X X X X X X X X X X
                XiezzoForCards	X X X X X X X X X X X X X X X X X X X X X X X X X X
                    thinkeryme	X X X X X X X X X X X X X X X X X X X X X X X X X X
                      wkathome	X X X X X X X X X X X X X X X X X X X X X X X X X X
                 BlogdoParrini	X X X X X X X X X X X X X X X X X X X X X X X X X X
                   Alexandeehr	X X X X X X X X X X X X X X X X X X X X X X X X X X
                    lizonomics	X X X X X X X X X X X X X X X X X X X X X X X X X X
                      snapagen	X X X X X X X X X X X X X X X X X X X X X X X X X X
               angelicanatasy3	X X X X X X X X X X X X X X X X X X X X X X X X X X
               ricardo_nicolau	X X X X X X X X X X X X X X X X X X X X X X X X X X
                    tw1tt3rart	X X X X X X X X X X X X X X X X X X X X X X X X X X
                Solandia_Twits	X X X X X X X X X X X X X X X X X X X X X X X X X X
                    Ryo_Apri27	X X X X X X X X X X X X X X X X X X X X X X X X X X
                    MeshayaMan	X X X X X X X X X X X X X X X X X X X X X X X X X X
                        Bybaki	_ _ _ _ _ _ _ _ _ _ _ _ _ _ _ X X X X X X X X X X X
                     NeutroRap	X X X X X X X X X X X X X X X X X X X X X X X X X X
               officecoworking	X X X X X X X X X X X X X X X X X X X X X X X X X X
                      aagggeee	X X X X X X X X X X X X X X X X X X X X X X X X X X
               iheartaffiliate	X X X X X X X X X X X X X X X X X X X X X X X X X X
                 Samurai_Ninja	X X X X X X X X X X X X X X X X X X X X X X X X X X
                GoHaRbOyFriEnD	X X X X X X X X X X X X X X X X X X X X X X X X X X
                      gegirmen	X X X X X X X X X X X X X X X X X X X X X X X X X X
                    GWAPCOUNTY	X X X X X X X X X X X X X X X X X X X X X X X X X X
                 bizsavvycoach	X X X X X X X X X X X X X X X X X X X X X X X X X X
               ArmandoSaeteurn	X X X X X X X X X X X X X X X X X X X X X X X X X X
                  philpalmieri	X X X X X X X X X X X X X X X X X X X X X X X X X X
                  collingarvey	X X X X X X X X X X X X X X X X X X X X X X X X X X
                    Janakabche	X X X X X X X X X X X X X X X X X X X X X X X X X X
                   johnbreslin	X X X X X X X X X X X X X X X X X X X X X X X X X X
                      w33dgirl	X X X X X X X X X X X X X X X X X X X X X X X X X X
                earltodrandall	X X X X X X X X X X X X X X X X X X X X X X X X X X
                        Top_DC	X X X X X X X X X X X X X X X X X X X X X X X X X X
                 vanya_susanin	X X X X X X X X X X X X X X X X X X X X X X X X X X
                     coisinha_	X X X X X X X X X X X X X X X X X X X X X X X X X X
                 JohnnyBrawooo	X X X X X X X X X X X X X X X X X X X X X X X X X X
                       Umayera	_ _ _ _ _ _ _ _ _ _ _ _ _ _ _ _ _ X X X X X X X X X
               shariiewahyunii	X X X X X X X X X X X X X X X X X X X X X X X X X X
                  OfMoshAndMen	X X X X X X X X X X X X X X X X X X X X X X X X X X
                       znakiay	X X X X X X X X X X X X X X X X X X X X X X X X X X
                ChuckJones1912	X X X X X X X X X X X X X X X X X X X X X X X X X X
               dickiiisuarsaa_	X X X X X X X X X X X X X X X X X X X X X X X X X X
                Micrositez_LLC	X X X X X X X X X X X X X X X X X X X X X X X X X X
               iPhone_Friendly	X X X X X X X X X X X X X X X X X X X X X X X X X X
                 OrlandoITPros	X X X X X X X X X X X X X X X X X X X X X X X X X X
                  Mella_sept17	X X X X X X X X X X X X X X X X X X X X X X X X X X
                      jpbenson	X X X X X X X X X X X X X X X X X X X X X X X X X X
                  robbschiller	X X X X X X X X X X X X X X X X X X X X X X X X X X
                Khair_Official	X X X X X X X _ _ _ _ _ _ _ _ _ _ _ _ _ _ _ _ _ _ _
                    lexalex475	_ _ _ _ _ _ X X X X X X X X X X X X X X X X X X X X
                 ShaunMelarkey	X X X X X X X X X X X X X X X X X X X X X X X X X X
                    SuziGaiser	X X X X X X X X X X X X X X X X X X X X X X X X X X
               Pr1meroJusticia	X X X X X X X X X X X X X X X X X X X X X X X X X X
                        EZYBID	X X X X X X X X X X X X X X X X X X X X X X X X X X
                   LivingAsMom	X X X X X X X X X X X X X X X X X X X X X X X X X X
                       sarriip	X X X X X X X X X X X X X X X X X X X X X X X X X X
                 telurumachiya	X X X X X X X X X X X X X X X X X X X X X X X X X X
                  JakeyGregory	X X X X X X X X X X X X X X X X X X X X X X X X X X
                   abyssknight	X X X X X X X X X X X X X X X X X X X X X X X X X X
                       mrbllyy	X X X X X X X X X X X X X X X X X X X X X X X X X X
                      soundwtf	X X X X X X X X X X X X X X X X X X X X X X X X X X
                  pa3kmartinez	X X X X _ _ _ _ _ _ _ _ _ _ _ _ _ _ _ _ _ _ _ _ _ _
                SportsLasVegas	X X X X X X X X X X X X X X X X X X X X X X X X X X
                ocduiattorneys	X X X X X X X X X X X X X X X X X X X X X X X X X X
                atlantis1staid	X X X X X X X X X X X X X X X X X X X X X X X X X X
                 briittanyyy19	X X X X X X X X X X X X X X X X X X X X X X X X X X
                   LanceyFresh	X X X X X X X X X X X X X X X X X X X X X X X X X X
                    sandividal	X X X X X X X X X X X X X X X X X X X X X X X X X X
                   ClayKustoms	X X X X X X X X X X X X X X X X X X X X X X X X X X
               ZlhaTekinKeskin	X X X X X X X X X X X X X X X X X X X X X X X X X X
                    grattonboy	X X X X X X X X X X X X X X X X X X X X X X X X X X
                    harsyaopal	X X X X X X X X X X X X X X X X X X X X X X X X X X
                    Tweet_Leap	X X X X X X X X X X X X X X X X X X X X X X X X X X
                 macaloni_king	X X X X X X X X X X X X X X X X X X X X X X X X X X
                         Gobav	X X X X X X X X X X X X X X X X X X X X X X X X X X
                     san131415	X X X X X X X X X X X X X X X X X X X X X X X X X X
                ellennangelina	X X X X X X X X X X X X X X X X X X X X X X X X X X
                      hseguias	X X X X X X X X X X X X X X X X X X X X X X X X X X
                 Mwpc_Official	X X X X X X X X X X X X X X X X X X X X X X X X X X
                AggressiveLabs	X X X X X X X X X X X X X X X X X X X X X X X X X X
                 ArbrasGallery	X X X X X X X X X X X X X X X X X X X X X X X X X X
                  famouscigars	X X X X X X X X X X X X X X X X X X X X X X X X X X
                     juhachiii	_ _ _ _ _ _ _ _ _ _ _ _ _ _ _ _ _ _ _ _ _ X X X X X
               Cattleboyzsauce	X X X X X X X X X X X X X X X X X X X X X X X X X X
               AlejoMarulanda_	X X X X X X X X X X X X X X X X X X X X X X X X X X
                AkoTheFujimaki	X X X X X X X X X X X X X X X X X X X X X X X X X X
                   ramon_arias	X X X X X X X X X X X X X X X X X X X X X X X X X X
                EnfermeiraFofa	X X X X X X X X X X X X X X X X X X X X X X X X X X
               DollarTwitrTool	X X X X X X X X X X X X X X X X X X X X X X X X X X
                     BrandoMtv	X X X X X X X X X X X X X X X X X X X X X X X X X X
                     Hengki_JR	X X X _ _ _ _ _ _ _ _ _ _ _ _ _ _ _ _ _ _ _ _ _ _ _
                   fscottmoody	X X X X X X X X X X X X X X X X X X X X X X X X X X
                 FocusElectInc	X X X X X X X X X X X X X X X X X X X X X X X X X X
                   Sentimently	X X X X X X X X X X X X X X X X X X X X X X X X X X
                  wedrivesales	X X X X X X X X X X X X X X X X X X X X X X X X X X
                     HFajardo_	X X X X X X X X X X X X X X X X X X X X X X X X X X
                    OliverPank	X X X X X X X X X X X X X X X X X X X X X X X X X X
                BobbyWashTweet	X X X X X X X X X X X X X X X X X X X X X X X X X X
                        Tawlk_	X X X X X X X X X X X X X X X X X X X X X X X X X X
               BrendaJuneCares	X X X X X X X X X X X X X X X X X X X X X X X X X X
                     JohnMHoyt	X X X X X X X X X X X X X X X X X X X X X X X X X X
                      am301986	X X X X X X X X X X X X X X X X X X X X X X X X X X
                   rezaalfaizi	X X X X X X X X X X X X X X X X X X X X X X X X X X
                        at3828	X X X X X X X X X X X X X X X X X X X X X X X X X X
                     media_gig	X X X X X X X X X X X X X X X X X X X X X X X X X X
                     Reemidepp	X X X X X X X X X X X X X X X X X X X X X X X X X X
                    omegatotal	X X X X X X X X X X X X X X X X X X X X X X X X X X
                         y88in	X X X X X X X X X X X X X X X X X X X X X X X X X X
                   BigBoySound	X X X X X X X X X X X X X X X X X X X X X X X X X X
                        mttvll	X X X X X X X X X X X X X X X X X X X X X X X X X X
                       wdhicks	X X X X X X X X X X X X X X X X X X X X X X X X X X
                     paul_tita	X X X X X X X X X X X X X X X X X X X X X X X X X X
                       mdscaff	X X X X X X X X X X X X X X X X X X X X X X X X X X
                    VMStormVPS	X X X X X X X X X X X X X X X X X X X X X X X X X X
                 Anon_Trolling	X X X X X X X X X X X X X X X X X X X X X X X X X X
                 Dudeknows_inc	X X X X X X X X X X X X X X X X X X X X X X X X X X
                      Af_ryand	X X X X X X X X X X X X X X X X X X X X X X X X X X
               HandsomeJimmyJR	X X X X X X X X X X X X X X X X X X X X X X X X X X
                   HamzaChamp2	X X X X X X X X X X X X X X X X X X X X X X X X X X
                bricksandbread	X X X X X X X X X X X X X X X X X X X X X X X X X X
               AlejandroRamosY	X X X X X X X X X X X X X X X X X X X X X X X X X X
                MiamiPcRepairs	X X X X X X X X X X X X X X X X X X X X X X X X X X
                          qrcd	X X X X X X X X X X X X X X X X X X X X X X X X X X
                        sivroy	X X X X X X X X X X X X X X X X X X X X X X X X X X
                     cozmodiva	X X X X X X X X X X X X X X X X X X X X X X X X X X
                     DynamiXWD	X X X X X X X X X X X X X X X X X X X X X X X X X X
                    CalderGage	X X X X X X X X X X X X X X X X X X X X X X X X X X
                      Romerout	X X X X X X X X X X X X X X X X X X X X X X X X X X
                      Rbenzeev	X X X X X X X X X X X X X X X X X X X X X X X X X X
                   H_Daniels32	_ _ _ _ _ _ _ _ _ _ _ _ _ _ _ _ _ _ _ X X X _ _ _ _
                ucanmakemebeat	X X X X X X X X X X X X X X X X X X X X X X X X X X
                TouchOfClassic	X X X X X X X X X X X X X X X X X X X X X X X X X X
                  abdulyakub01	X X X X X X X X X X X X X X X X X X X X X X X X X X
                  erfolgstexte	X X X X X X X X X X X X X X X X X X X X X X X X X X
                        DIVUPS	X X X X X X X X X X X X X X X X X X X X X X X X X X
                     rob_larue	X X X X X X X X X X X X X X X X X X X X X X X X X X
                   kleryoussef	X X X X X X X X X X X X X X X X X X X X X X X X X X
                     enoyozee2	X X X X X X X X X X X X X X X X X X X X X X X X X X
               Captain_Zikri14	X X X X X X X X X X X X X X X X X X X X X X X X X X
                  startuptampa	X X X X X X X X X X X X X X X X X X X X X X X X X X
                  iamJeffCohen	X X X X X X X X X X X X X X X X X X X X X X X X X X
                      Simon_An	X X X X X X X X X X X X X X X X X X X X X X X X X X
                  andrewmriley	X X X X X X X X X X X X X X X X X X X X X X X X X X
                     fayfeeney	X X X X X X X X X X X X X X X X X X X X X X X X X X
               KidWithBigDream	X X X X X X X X X X X X X X X X X X X X X X X X X X
                    __iTweet__	X X X X X X X X X X X X X X X X X X X X X X X X X X
                      diooodmr	X X X _ _ _ _ _ _ _ _ _ _ _ _ _ _ _ _ _ _ _ _ _ _ _
                      mohnacky	X X X X X X X X X X X X X X X X X X X X X X X X X X
                     Ravilja70	X X X X X X X X X X X X X X X X X X X X X X X X X X
                    You_Linger	X X X X X X X X X X X X X X X X X X X X X X X X X X
                      sukideli	X X X X X X X X X X X X X X X X X X X X X X X X X X
                   Ascentology	X X X X X X X X X X X X X X X X X X X X X X X X X X
               MacKidCedarRpds	X X X X X X X X X X X X X X X X X X X X X X X X X X
                   simplenigma	X X X X X X X X X X X X X X X X X X X X X X X X X X
               flipflipmeheidi	X X X X X X X X X X X X X X X X X X X X X X X X X X
                   BarbieAriel	X X X X X X X X X X X X X X X X X X X X X X X X X X
                CameronKeven09	X X X X X X X X X X X X X X X X X X X X X X X X X X
                        mrdazm	X X X X X X X X X X X X X X X X X X X X X X X X X X
                     Ramilja78	X X X X X X X X X X X X X X X X X X X X X X X X X X
                       f00bard	X X X X X X X X X X X X X X X X X X X X X X X X X X
                  JonLeeMiller	X X X X X X X X X X X X X X X X X X X X X X X X X X
                        zeekay	X X X X X X X X X X X X X X X X X X X X X X X X X X
                Donata_Wedding	X X X X X X X X X X X X X X X X X X X X X X X X X X
                   CraigKausen	X X X X X X X X X X X X X X X X X X X X X X X X X X
                     mariexndr	X X X X X X X X X X X X X X X X X X X X X X X X X X
                   Arindagiyan	_ _ _ _ _ _ _ _ _ _ X X X X X X X X X X X X X X X X
                    trinigeek0	X X X X X X X X X X X X X X X X X X X X X X X X X X
               akira_ciptohadi	X X X X X X X X X X X X X X X X X X X X X X X X X X
                     thinkgeek	X X X X X X X X X X X X X X X X X X X X X X X X X X
               Blog_comubrasil	X X X X X X X X X X X X X X X X X X X X X X X X X X
                    sibirianka	X X X X X X X X X X X X X X X X X X X X X X X X X X
                   kylecsteele	X X X X X X X X X X X X X X X X X X X X X X X X X X
                   TheGoodShit	X X X X X X X X X X X X X X X X X X X X X X X X X X
                  cosmicyogapw	X X X X X X X X X X X X X X X X X X X X X X X X X X
                    tiobillpay	X X X X X X X X X X X X X X X X X X X X X X X X X X
                 ingenuitasinc	X X X X X X X X X X X X X X X X X X X X X X X X X X
                       FALband	X X X X X X X X X X X X X X X X X X X X X X X X X X
                       skernes	X X X X X X X X X X X X X X X X X X X X X X X X X X
                      naryachy	X X X X X X X X X X X X X X X X X X X X X X X X X X
                  glenisgraham	_ _ _ _ _ _ _ _ _ _ _ _ _ X X X X X X X X X X X X X
                      HoLmedia	X X X X X X X X X X X X X X X X X X X X X X X X X X
                   Vinitaeclev	X X X X X X X X X X X X X X X X X X X X X X X X X X
                     aantthony	X X X X X X X X X X X X X X X X X X X X X X X X X X
                        mtubes	X X X X X X X X X X X X X X X X X X X X X X X X X X
                  openinspires	X X X X X X X X X X X X X X X X X X X X X X X X X X
                  NeathenAlero	X X X X X X X X X X X X X X X X X X X X X X X X X X
                       FucxkEm	X X X X X X X X X X X X X X X X X X X X X X X X X X
                        EzLoot	X X X X X X X X X X X X X X X X X X X X X X X X X X
                       MAForum	X X X X X X X X X X X X X X X X X X X X X X X X X X
                  wahyuhrmawan	X X X X X X X X X X X X X X X X X X X X X X X X X X
                     OMGpublic	_ _ _ _ _ _ _ _ _ _ _ _ _ _ X X X X X X X X X X X X
                       DoveCDs	X X X X X X X X X X X X X X X X X X X X X X X X X X
                     leonwical	_ _ X X X X X X X X X X X X X X X X X X X X X X X X
                    tomodacy15	X X X X X X X X X X X X X X X X X X X X X X X X X X
                  ForkRobotics	X X X X X X X X X X X X X X X X X X X X X X X X X X
                     DonLi1210	X X X X X X X X X X X X X X X X X X X X X X X X X X
                        kpeavs	X X X X X X X X X X X X X X X X X X X X X X X X X X
                 vijay_lingesh	X X X X X X X X X X X X X X X X X X X X X X X X X X
                  AlexSchleber	X X X X X X X X X X X X X X X X X X X X X X X X X X
                   hostel_jobs	X X X X X X X X X X X X X X X X X X X X X X X X X X
                     MikeBaggz	X X X X X X X X X X X X X X X X X X X X X X X X X X
                    kojiundone	X X X X X X X X X X X X X X X X X X X X X X X X X X
                       IMGuru5	X X X X X X X X X X X X X X X X X X X X X X X X X X
                   KaX_takashi	X X X X X X X X X X X X X X X X _ _ _ _ _ _ _ _ _ _
                     SandyHack	X X X X X X X X X X X X X X X X X X X X X X X X X X
                     kutu_gaul	X X X X X X X X X X X X X X X X X X X X X X X X X X
                     pingdroid	X X X X X X X X X X X X X X X X X X X X X X X X X X
                StartFloridaUp	X X X X X X X X X X X X X X X X X X X X X X X X X X
               santoshasthana4	X X X X X X X X X X X X X X X X X X X X X X X X X X
                PainKiller0426	X X X X X X X X X X X X X X X X X X X X X X X X X X
                 mr_spongebobz	X X X X X X _ _ _ _ _ _ _ _ _ _ _ _ _ _ _ _ _ _ _ _
                 SelfishPrick2	X X X X X X X X X X X X X X X X X X X X X X X X X X
                    eazybishop	X X X X X X X X X X X X X X X X X X X X X X X X X X
                   citmarbella	X X X X X X X X X X X X X X X X X X X X X X X X X X
                   GetLikeHits	X X X X X X X X X X X X X X X X X X X X X X X X X X
                 TheJordaneers	X X X X X X X X X X X X X X X X X X X X X X X X X X
                     tony_winn	X X X X X X X X X X X X X X X X X X X X X X X X X X
                  1ezwebdesign	X X X X X X X X X X X X X X X X X X X X X X X X X X
                    CMcClaskie	X X X X X X X X X X X X X X X X X X X X X X X X X X
                      KINGRPG0	X X X X X X X X X X X X X X X X X X X X X X X X X X
                 tsukamoto_ya2	X X X X X X X X X X X X X X X X X X X X X X X X X X
                         AK_82	X X X X X X X X X X X X X X X X X X X X X X X X X X
               MartiniParty007	X X X X X X X X X X X X X X X X X X X X X X X X X X
                          DEMO	X X X X X X X X X X X X X X X X X X X X X X X X X X
                DonnaLSpangler	X X X X X X X X X X X X X X X X X X X X X X X X X X
                       jsiples	X X X X X X X X X X X X X X X X X X X X X X X X X X
                JournalofValue	X X X X X X X X X X X X X X X X X X X X X X X X X X
                MatthewClosson	X X X X X X X X X X X X X X X X X X X X X X X X X X
                      wuwanhua	X X X X X X X X X X X X X X X X X X X X X X X X X X
                   UlyssesMiro	X X X X X X X X X X X X X X X X X X X X X X X X X X
                     nama_nayy	X X X X X X X X X X X X X X X X X X X X X X X X X X
               EstablishedEcom	X X X X X X X X X X X X X X X X X X X X X X X X X X
                   MaryCristy1	X X X X X X X X X X X X X X X X X X X X X X X X X X
                 AjinkyaForYou	X X X X X X X X X X X X X X X X X X X X X X X X X X
               ChelseaBrowning	X X X X X X X X X X X X X X X X X _ _ _ _ _ _ _ _ _
                     Milieunet	X X X X X X X X X X X X X X X X X X X X X X X X X X
                     TheOnlyJa	X X X X X X X X X X X X X X X X X X X X X X X X X X
                      Achirura	X X X X X X X X X X X X X X X X X X X X X X X X X X
                    Lijah2Cold	X X X X X X X X X X X X X X X X X X X X X X X X X X
                  jeffltaylor2	X X X X X X X X X X X X X X X X X X X X X X X X X X
                 HEELBellaArmy	X X X X X X X X X X X X X X X X X X X X X X X X X X
                hirobe_housing	X X X X X X X X X X X X X X X X X X X X X X X X X X
                    yuztechseo	X X X X X X X X X X X X X X X X X X X X X X X X X X
                 MasterMixPage	_ _ _ _ _ _ _ _ _ _ _ _ _ _ _ _ _ X X X X X X X X X
               AlexeyPermaykov	X X X X X X X X X X X X X X X X X X X X X X X X X X
                  12Vspotlight	X X X X X X X X X X X X X X X X X X X X X X X X X X
                       venVelo	X X X X X X X X X X X X X X X X X X X X X X X X X X
                   AriyoReggae	_ _ _ _ _ _ _ _ _ _ _ _ X X X X X X X X X X X X X X
                         r1cky	X X X X X X X X X X X X X X X X X X X X X X X X X X
                   CarlinhosVP	X X X X X X X X X X X X X X X X X X X X X X X X X X
                  Marisca_LiCh	X X X X X X X X X X X X X X X X X X X X X X X X X X
                      leoretro	X X X X X X X X X X X X X X X X X X X X X X X X X X
                 nahidislam350	X X X X X X X X X X X X X X X X X X X X X X X X X X
               TheLightWizzard	X X X X X X X X X X X X X X X X X X X X X X X X X X
                    DougCumbie	X X X X X X X X X X X X X X X X X X X X X X X X X X
                   ashejonline	X X X X X X X X X X X X X X X X X X X X X X X X X X
                   KCTICKETGUY	X X X X X X X X X X X X X X X X X X X X X X X X X X
                SpiritualLevel	X X X X X X X X X X X X X X X X X X X X X X X X X X
                   ItuBukanGue	X X X X X X X X X X X X X X X _ _ _ _ _ _ _ _ _ _ _
                    MediaMeNow	X X X X X X X X X X X X X X X X X X X X X X X X X X
               BeABetterFather	X X X X X X X X X X X X X X X X X X X X X X X X X X
                         1Fhsm	X X X X X X X X X X X X X X X X X X X X X X X X X X
                 hisato_takeya	X X X X X X X X X X X X X X X X X X X X X X X X X X
                     lazaruchi	X X X X X X X X X X X X X X X X X X X X X X X X X X
                       hipnoyo	_ X X X X X X X X X X X X X X X X X X X X _ _ _ _ _
                 anthopayangan	X X X X X X X X X X X X X X X X X X X X X X X X X X
               preciousstarfyi	X X X X X X X X X X X X X X X X X X X X X X X X X X
               KneeKeyPieEight	X X X X X X X X X X X X X X X X X X X X X X X X X X
                      ViennaCC	X X X X X X X X X X X X X X X X X X X X X X X X X X
                  LeovhieCuevo	X X X X X X X X X X X X X X X X X X X X X X X X X X
                ShiroUnlimited	X X X X X X X X X X X X X X X X X X X X X X X X X X
                         golug	X X X X X X X X X X X X X X X X X X X X X X X X X X
                thejewelseeker	X X X X X X X X X X X X X X X X X X X X X X X X X X
                    rails_apps	X X X X X X X X X X X X X X X X X X X X X X X X X X
                  AfterDarkDev	X X X X X X X X X X X X X X X X X X X X X X X X X X
                  burakkilic54	X X X X X X X X X X X X X X X X X X X X X X X X X X
                     lensskins	X X X X X X X X X X X X X X X X X X X X X X X X X X
                Senba_Kaientai	X X X X X X X X X X X X X X X X X X X X X X X X X X
                   ofilispeaks	X X X X X X X X X X X X X X X X X X X X X X X X X X
                      tasyabcd	X X X X X X X X X X X X X X X X X X X X X X X X X X
                   AricVinacke	X X X X X X X X X X X X X X X X X X X X X X X X X X
                     Parrinix1	X X X X X X X X X X X X X X X X X X X X X X X X X X
               andyobrienmusic	X X X X X X X X X X X X X X X X X X X X X X X X X X
                   Troyanosoft	X X X X X X X X X X X X X X X X X X X X X X X X X X
                justandperfect	X X X X X X X X X X X X X X X X X X X X X X X X X X
                SnapbackChicks	X X X X X X X X X X X X X X X X X X X X X X X X X X
                       tdy0123	X X X X X X X X X X X X X X X X X X X X X X X X X X
               FrontierOdyssey	X X X X X X X X X X X X X X X X X X X X X X X X X X
                     adampriam	X X X X X X X X X X X X X X X X X X X X X X X X X X
                        szeliu	X X X X X X X X X X X X X X X X X X X X X X X X X X
                  insider_page	X X X X X X X X X X X X X X X X X X X X X X X X X X
                  eoin16_kelly	_ _ _ X X X X X X X X X X X X X X X X X X X X X X X
                    yossifadli	_ _ _ _ _ _ _ _ _ _ _ _ _ _ _ _ _ _ _ _ _ _ _ X X X
                        jjjrmy	X X X X X X X X X X X X X X X X X X X X X X X X X X
                      Webatrio	X X X X X X X X X X X X X X X X X X X X X X X X X X
                   MIqbalDaniS	X X X X X X X X X X X X X X X X X X X X X X X X X X
                   phin_auliaw	X X X X X X X X X X X X X X X X X X X X X X X X X X
                    eDomaining	X X X X X X X X X X X X X X X X X X X X X X X X X X
                 India_Unearth	X X X X X X X X X X X X X X X X X X X X X X X X X X
                Gurdian_Angel_	X X X X X X X X X X X X X X X X X X X X X X X X X X
                      _mreyes_	X X X X X X X X X X X X X X X X X X X X X X X X X X
                      notifyin	X X X X X X X X X X X X X X X X X X X X X X X X X X
                   komypotolok	X X X X X X X X X X X X X X X X X X X X X X X X X X
                 MyIntersperse	X X X X X X X X X X X X X X X X X X X X X X X X X X
                      onurccem	X X X X X X X X X X X X X X X X X X X X X X X X X X
                    nicoleanne	X X X X X X X X X X X X X X X X X X X X X X X X X X
                      ItsPrepp	X X X X X X X X X X X X X X X X X X X X X X X X X X
                   SuperKhylie	_ _ _ _ _ X X X X X X X X X X X X X X X X X X X X X
                zainul_rocklee	X X X X X X X X X X X X X X X X X X X X X X X X X X
                     robdbirch	X X X X X X X X X X X X X X X X X X X X X X X X X X
                XLovingJamunsX	X X X X X X X X X X X X X X X X X X X X X X X X X X
                   belfastbaps	X X X X X X X X X X X X X X X X X X X X X X X X X X
                           AVV	X X X X X X X X X X X X X X X X X X X X X X X X X X
                       iamyadi	X X X X X X X X X X X X X X X X X X X X X X X X X X
                ModisITOrlando	X X X X X X X X X X X X X X X X X X X X X X X X X X
                 alarmingsword	X X X X X X X X X X X X X X X X X X X X X X X X X X
                       stay_du	X X X X X X X X X X X X X X X X X X X X X X X X X X
                   adamfortuna	X X X X X X X X X X X X X X X X X X X X X X X X X X
                       WebSecu	X X X X X X X X X X X X X X X X X X X X X X X X X X
                VincentFavilla	X X X X X X X X X X X X X X X X X X X X X X X X X X
                 ImHarrysBabee	X X X X X X X X X X X X X X X X X X X X X X X X X X
                    Schwantzel	X X X X X X X X X X X X X X X X X X X X X X X X X X
                       03lizza	X X X X X X X X X X X X X X X X X X X X X X X X X X
                     coninsync	X X X X X X X X X X X X X X X X X X X X X X X X X X
                    DJCODEKANE	X X X X X X X X X X X X X X X X X X X X X X X X X X
                 takaya_heaven	X X X X X X X X X X X X X X X X X X X X X X X X X X
                   MagnumCraig	X X X X X X X X X X X X X X X X X X X X X X X X X X
               MelissaGrimmond	X X X X X X X X X X X X X X X X X X X X X X X X X X
                     mikedfunk	X X X X X X X X X X X X X X X X X X X X X X X X X X
                    masood1308	X X X X X X X X X X X X X X X X X X X X X X X X X X
                    JediEnergy	X X X X X X X X X X X X X X X X X X X X X X X X X X
                         dcamp	X X X X X X X X X X X X X X X X X X X X X X X X X X
                      PatLagos	X X X X X X X X X X X X X X X X X X X X X X X X X X
                   ishouldstay	X X X X X X X X X X X X X X X X X X X X X X X X X X
                yumeoibitonohi	X X X X X X X X X X X X X X X X X X X X X X X X X X
                   GagaINspace	X X X X X X X X X X X X X X X X X X X X X X X X X X
                  stackiepants	X X X X X X X X X X X X X X X X X X X X X X X X X X
                     billy_wjY	X X X X X X X X X X X X X X X X X X X X X X X X X X
                   submit_site	X X X X X X X X X X X X X X X X X X X X X X X X X X
                 koran_jakarta	X X X X X X X X X X X X X X X X X X X X X X X X X X
                Luciano_Abarca	X X X X X X X X X X X X X X X X X X X X X X X X X X
                MatthewASolari	X X X X X X X X X X X X X X X X X X X X X X X X X X
                 CarlosParrini	X X X X X X X X X X X X X X X X X X X X X X X X X X
                     Jamesqq15	X X X X X X X X X X X X X X X X X X X X X X X X X X
                  Deguchioni36	X X X X X X X X X X X X X X X X X X X X X X X X X X
               rightgoal777xyz	X X X X X X X X X X X X X X X X X X X X X X X X X X
                   CliffordRoa	X X X X X X X X X X X X X X X X X X X X X X X X X X
                 AndrewsScotty	X X X X X X X X X X X X X X X X X X X X X X X X X X
                  YenziieChiix	X X X X X X X X X X X X X X X X X X X X X X X X X X
                satou_yukinobu	X X X X X X X X X X X X X X X X X X X X X X X X X X
                    mkultra329	X X X X X X X X X X X X X X X X X X X X X X X X X X
                metalloid_emon	X X X X X X X X X X X X X X X X X X X X X X X X X X
                   cardiacband	X X X X X X X X X X X X X X X X X X X X X X X X X X
                     Prognolic	X X X X X X X X X X X X X X X X X X X X X X X X X X
                 asprettyasdis	X X X X X X X X X X X X X X X X X X X X X X X X X X
                   JaeMayor414	X X X X X X X X X X X X X X X X X X X X X X X X X X
                    developsis	X X X X X X X X X X X X X X X X X X X X X X X X X X
                       mexitek	X X X X X X X X X X X X X X X X X X X X X X X X X X
                      roby_1st	X X X X X X X X X X X X X X X X X X X X X X X X X X
                      SCWBooks	X X X X X X X X X X X X X X X X X X X X X X X X X X
                      sjbanduk	X X X X X X X X X X X X X X X X X X X X X X X X X X
                       RaDjara	X X X X X X X X X X X X X X X X X X X X X X X X X X
                 IchaMuffin007	X X X X X X X X X X X X X X X X X X X X X X X X X X
                   dickyzulard	_ _ _ _ _ _ _ _ _ _ _ _ _ _ _ _ _ _ _ _ X X X X _ _
                 TweetWillHall	X X X X X X X X X X X X X X X X X X X X X X X X X X
               Hizkiasianipar1	X X X X X X X X X X X X X X X X X X X X X X X X X X
                      gisernia	X X X X X X X X X X X X X X X X X X X X X X X X X X
                   BryanAgaton	X X X X X X X X X X X X X X X X X X X X X X X X X X
                      tsoporan	X X X X X X X X X X X X X X X X X X X X X X X X X X
                      NikkiPi8	X X X X X X X X X X X X X X X X X X X X X X X X X X
                  VaHappenin1D	X X X X X X X X X X X X X X X X X X X X X X X X X X
               JaeMixedKenD0ll	_ _ _ _ _ _ _ _ _ _ _ _ _ _ _ _ _ _ _ _ _ _ _ _ X X
                   BrunoLeon09	X X X X X X X X X X X X X X X X X X X X X X X X X X
                TrippyMane_LEX	X X X X X X X X X X X X X X X X X X X X X X X X X X
                     Simple_CV	X X X X X X X X X X X X X X X X X X X X X X X X X X
                         TMone	X X X X X X X X X X X X X X X X X X X X X X X X X X
                Vittaduwientta	X X X X X X X X X X X X X X X X X X X X X X X X X X
                  aryangrewal1	X X X X X X X X X X X X X X X X X X X X X X X X X X
                   Leanservers	X X X X X X X X X X X X X X X X X X X X X X X X X X
                      rerewell	X X X X X X X X X X X X X X X X X X X X X X X X X X
                     ashpash21	X X X X X X X X X X X X X X X X X X X X X X X X X X
                   Anton_putra	X X X X X X X X X X X X X X X X X X X X X X X X X X
                        9arasi	X X X X X X X X X X X X X X X X X X X X X X X X X X
                 AwesomeDeepee	_ _ _ _ _ _ _ _ X X X X X X X X X X X X X X X X X X
               EvexaClinesywDR	X X X X X X X X X X X X X X X X X X X X X X X X X X
                ThatGuyMarkkus	X X X X X X X X X X X X X X X X X X X X X X X X X X
                      ttuesday	X X X X X X X X X X X X X X X X X X X X X X X X X X
                      liberatr	X X X X X X X X X X X X X X X X X X X X X X X X X X
                safaet_hossain	X X X X X X X X X X X X X X X X X X X X X X X X X X
                      tracia10	X X X X X X X X X X X X X X X X X X X X X X X X X X
                    itsme_ayuu	X X X X X X X X X X X X X X X X X X X X X X X X X X
                  Matyas_Godoy	X X X X X X X X X X X X X X X X X X X X X X X X X X
                     inanocchi	X X X X X X X X X X X X X X X X X X X X X X X X X X
                     TSancilar	X X X X X X X X X X X X X X X X X X X X X X X X X X
                       yawabba	X X X X X X X X X X X X X X X X X X X X X X X X X X
                  Highlighthwd	X X X X X X X X X X X X X X X X X X X X X X X X X X
                    MistaKitty	X X X X X X X X X X X X X X X X X X X X X X X X X X
               FlyingBallsacks	X X X X X X X X X X X X X X X X X X X X X X X X X X
               CarlosAlfonzoCR	X X X X X X X X X X X X X X X X X X X X X X X X X X
                     diarreola	X X X X X X X X X X X X X X X X X X X X X X X X X X
                513topnotch513	X X X X X X X X X X X X X X X X X X X X X X X X X X
                    Nico_Kills	X X X X X X X X X X X X X X X X X X X X X X X X X X
                     DKGRStock	X X X X X X X X X X X X X X X X X X X X X X X X X X
                        mecjay	X X X X X X X X X X X X X X X X X X X X X X X X X X
                      Rupor_UA	X X X X X X X X X X X X X X X X X X X X X X X X X X
                       AlmazGZ	X X X X X X X X X X X X X X X X X X X X X X X X X X
                    FidanHarun	X X X X X X X X X X X X X X X X X X X X X X X X X X
                  FredBantados	X X X X X X X X X X X X X X X X X X X X X X X X X X
               CandiCunningham	X X X X X X X X X X X X X X X X X X X X X X X X X X
                     Jobs_4_Me	X X X X X X X X X X X X X X X X X X X X X X X X X X
                  kuliit_mitch	_ _ _ _ _ _ _ _ _ _ _ X X X X X X X X X X X X X X X
                  jjjinvesting	X X X X X X X X X X X X X X X X X X X X X X X X X X
                  Rarezas_info	X X X X X X X X X X X X X X X X X X X X X X X X X X
                BrankoIvatovic	X X X X X X X X X X X X X X X X X X X X X X X X X X
                     Twetkolik	X X X X X X X X X X X X X X X X X X X X X X X X X X
                  Brayan__Diaz	X X X X X X X X X X X X X X X X X X X X X X X X X X
                  SunnySleevez	X X X X X X X X X X X X X X X X X X X X X X X X X X
                   Ocha_ochudt	X X X X X X X X X X X X X _ _ _ _ _ _ _ _ _ _ _ _ _
                   Nadiyyah250	X X X X X X X X X X X X X X X X X X X X X X X X X X
                     capilanna	X X X X X X X X X X X X X X X X X X X X X X X X X X
                  Wealth_Daddy	X X X X X X X X X X X X X X X X X X X X X X X X X X
                 VivaBreitbart	X X X X X X X X X X X X X X X X X X X X X X X X X X
                  Kevin_viNadz	X X X X X X X X X X X X X X X X X X X X X X X X X X
                      oddielou	X X X X X X X X X X X X X X X X X X X X X X X X X X
                    ceaserachi	X X X X X X X X X X X X X X X X X X X X X X X X X X
                        rirera	X X X X X X X X X X X X X X X X X X X X X X X X X X
                   orlandodojo	X X X X X X X X X X X X X X X X X X X X X X X X X X
                         eifc7	X X X X X X X X X X X X X X X X X X X X X X X X X X
                     jpadilla_	X X X X X X X X X X X X X X X X X X X X X X X X X X
                 fajarnugrha15	X X X X X X X X X X X X X X X X X X X X X X X X X X
                Gulsumkarakurt	X X X X X X X X X X X X X X X X X X X X X X X X X X
                 BiarGueFollow	_ _ _ _ _ _ _ _ _ _ _ _ _ _ _ X X X X X X X X X X X
                         DTFtx	X X X X X X X X X X X X X X X X X X X X X X X X X X
                    dynarahmaa	X X X X X X X X X X X X X X X X X X X X X X X X X X
               CarlosCarbonell	X X X X X X X X X X X X X X X X X X X X X X X X X X
                DavidFernandoC	X X X X X X X X X X X X X X X X X X X X X X X X X X
                        dfbova	X X X X X X X X X X X X X X X X X X X X X X X X X X
                     edocandop	X X X X X X X X X X X X X X X X X X X X X X X X X X
                    ajcampos01	X X X X X X X X X X X X X X X X X X X X X X X X X X
                        alexdc	X X X X X X X X X X X X X X X X X X X X X X X X X X
               gstocker_office	X X X X X X X X X X X X X X X X X X X X X X X X X X
                   NevCulinary	X X X X X X X X X X X X X X X X X X X X X X X X X X
